Mark Seibert

birthday: n/a

Police Quest II: The Vengeance
Quest for Glory: So You Want to Be a Hero
Codename: Iceman
Conquests of Camelot: The Search for the Grail
King's Quest V: Absence Makes the Heart Go Yonder!
Mixed-Up Mother Goose
King's Quest VI: Heir Today, Gone Tomorrow
Conquests of the Longbow: The Legend of Robin Hood
Phantasmagoria
Leisure Suit Larry: Love for Sail!
King's Quest IV: The Perils of Rosella
Space Quest III: The Pirates of Pestulon
 (1988) (Musician/Editor)
Silpheed
Firehawk: Thexder The Second Contact
Leisure Suit Larry 3: Passionate Patti in Pursuit of the Pulsating Pectorals
Hoyle's Official Book of Games: Volume 1
King's Quest I: Quest for the Crown
Space Quest IV: Roger Wilco and the Time Rippers
Oil's Well
Police Quest III: The Kindred
Quest for Glory II: Trial by Fire
Hoyle's Official Book of Games: Volume 2
Hoyle's Official Book of Games: Volume 3
EcoQuest: The Search for Cetus
Castle of Dr. Brain
Space Quest I: Roger Wilco in the Sarien Encounter
Leisure Suit Larry in the Land of the Lounge Lizards
Leisure Suit Larry 5: Passionate Patti Does a Little Undercover Work
Mixed-Up Fairy Tales
Quest for Glory I: So You Want to Be a Hero
Police Quest: In Pursuit of the Death Angel
Jones in the Fast Lane
Laura Bow: The Dagger of Amon Ra
The Island of Dr. Brain
Take-a-Break! Pinball for Windows
Pepper's Adventures in Time
The Shadow of Yserbius
Gabriel Knight: Sins of the Fathers
Quest for Glory III: Wages of War
Outpost
King's Quest VII: The Princeless Bride
Torin's Passage
Leisure Suit Larry: Love for Sail!
King's Quest: Mask of Eternity
Arcanum: Of Steamworks and Magick Obscura
Throne of Darkness
